11111
10001
100011
100011
111111