111111111111111
100100000000001
100100000000001
100000000000001
100000000000001
100000000000001
100000001000001
100000001000001
100011111111111
10001
11111
