NO ./textures/stone2.png
SO ./textures/grass2.png
WE ./textures/stone2.png
EA ./textures/grass2.png

C 139,69,19
F 135, 206, 235


        1111111111111111111111111
        1000000000110000000000001
        1011000001110000111000001
        10010000000000001 1000001
111111111011000001110000111000001
100000000011000001110111111111110
11110111111111011100000010001
11110111111111011101010010001
11000000110101011100000010001
10000000000000001100000010001
10000000000000001101010010001
11000001110101011111011000N01
11110111 1110101 101111010001
11111111 1111111 111111111111
